10.ox
.o....ooo.
...oo..o..
.......o..
.o..o..o..
o...o...o.
.........o
....o.....
....o.....
o....oooo.
........o.
