8-*#
*--***-*
****-**-
*--*-*-*
-*---***
--*-**--
-*--**-*
-*-**--*
