9./x
./..////.
.///.././
././/....
././.././
..///./..
/....////
..../../.
//..//./.
//.././/.
